NO ./xpm/N.xpm
SO ./xpm/S.xpm
WE ./xpm/W.xpm
EA ./xpm/E.xpm

F 120,111,100   
C 225,225,225                


    1111111111111111111111
    1000000000000000000001
    100000000000N000000001
    1000000010000000000001
    1111111111111111111111