1111111111111111111111111111
1E0000000011111110000C0000C1
11100100000000C0101001010101
1C10010000111111101001010101
100000000C00C0000000000000P1
1111111111111111111111111111