111111111111111111111111111111
1C0000C00000C000C000000C000011
100111111111111111111111110011
1C0000C00C000000000000000C1011
111111111111100011C00011110C11
1C0000000000000011000000C10011
111111110001111111111100010011
100000C10C00000C1110C000010111
100011111111111111100000110011
1C000000000000001100001C010C11
1111111111111100000C0011110011
1P000000000000C00000001111E011
111111111111111111111111111111