1111111111111          
1P00000000E01
1000010000001
100C010000001
1111111111111