1111111111111
1P01000000000
1P00010000001
100C010000001
111111111